NO ./image/mc1.xpm
SO ./image/mc2.xpm
WE ./image/mc3.xpm
EA ./image/mc4.xpm

F 0,0,255
C 182,182,0

111111111111111111111111111111111111111111111111111111111111
100000000000000000000000000000000000000000000000000000000001
100000000000000000000000000000000000000000000000000000000001
100000000000000000000000000000000000000000000000000000000001
100000000000000000000000000000000000000000000000000000000001
100000000000000000000000000000000000000000000000000000000001
100000000000001111111111111000000000011111111111100000000001
100000000000001           100000000001          100000000001
100000000000001           100000000001          100000000001
100000000000001           100000000001          100000000001
10000000000000111111111111100000N000011111111111100000000001
100000000000000000000000000000000000000000000000000000000001
100000000000000000000000000001111000000000000000000000000001
100000000000000000000000000001   1000000000000000000000000001
111111111111111000000000000001   100000000000000000000000001111111111111111
              100000000000001111111111111000000000011111111111100000000001
              100000000000001     100000000001111111111110000000000111111111111
              100000000000001     1000000000011111111111100000000001
              100000000000001     100000000001111111111110000000000111111111111
              100000000000000111111111111000000000011111111111100000000001
              100000000000000000000000000000000000000000000000000000000001
              100000000000000000000000000000000000000000000000000000000001
              100000000000000000000000000000000000000000000000000000000001
              100000000000000000000000000000000000000000000000000000000001
              100000000000000000000000000000000000000000000000000000000001
              111111111111111111111111111111111111111111111111111111111111