NO ./image/wall1.xpm
SO ./image/wall2.xpm
WE ./image/wall3.xpm
EA ./image/wall4.xpm

F 0,0,255
C 182,182,0

1111111111111111111
1000000011111111111
1000000011
11100000011
1100N00111
1110001111
111001111111111111
100001110000000001
10001  10000000001
10001  10000000001
100011110000000001
100000000111111111
1000100001
1100000111
1111111111