NO ./image/wall1.xpm
SO ./image/wall2.xpm
WE ./image/wall3.xpm
EA ./image/wall4.xpm

C 0,0,255
F 100,100,100

11111111111111
10000000000001
10000000000001
10000000000001
1000S000000001		1
10000000000001
10000000000001
11111111111111