1111111111111
1P010C00000C1
1000011111C01
1C0C11E00C001
1111111111111